|-----------------------------------------------------------------------------|
|                                                                             |
| |--------------------------|        |-----------------------|               |
| |......@...........0.......|        |..N......T...........7.|               |
| |..W................W......+########+.......................|-------|       |
| |...........6..............|   #    |.........N...........N.........|--|    |
| |.....V...............M....|   #    |.1................................|--| |
| |----------+---------------|   #    |----+----------------|...............| |
|            #                 #############                |.........9.....| |
|            #                 #     |-----+------|         |.X........D....| |
|            #                 #     |....V....8..|         |...............| |
|            ###################     |....\.......|   ######+....P..........| |
|            #                 #     |....V....0..|   #     |...............| |
|            #                 #     |-----+------|   #     |--------+------| |
|  |---------+-----------|     #           #          #              #        |
|  |....N...........T....|     #           #          #         |----+------| |
|  |............7........|     ########################         |...........| |
|  |.....T...............|     #           #                    |...8.6.....| |
|  |.....................|     #    |------+--------------------|...........| |
|  |.............T.......|     #    |.......................................| |
|  |................5....+##########+......W......4.....N..............W....| |
|  |...V6................|          |.............................3.........| |
|  |---------------------|          |---------------------------------------| |
|                                                                             |
|-----------------------------------------------------------------------------|
